[73, 100, 99, 88, 71, 60, 74, 28, 72, 29]
[93, 40, 11, 7, 94, 59, 53, 44, 1, 65]
[78, 77, 15, 44, 59, 79, 86, 68, 100, 14]
[25, 95, 45, 78, 15, 74, 71, 73, 96, 34]
[48, 2, 54, 80, 53, 59, 49, 4, 72, 94]
[56, 46, 17, 88, 92, 88, 99, 79, 79, 98]
[90, 16, 41, 57, 76, 85, 16, 11, 22, 90]
[63, 94, 50, 15, 43, 80, 12, 3, 6, 49]
[39, 23, 9, 16, 39, 82, 12, 31, 78, 64]
[12, 12, 92, 25, 9, 45, 56, 10, 59, 64]
